# 種族和政體
Species - 種族（星際文明）;物種（未開化的、低階文明、泛稱（examli gratia 智慧物種））
Trait - 特質
Ethic - 道德觀;道德(的);道德準則
Ethos - 道德準則
Collectivism - 集體本位論
Collectivist - 集體本位者;集體本位(的);集體本位論
Individualism - 個體本位論
Individualist - 個體本位者;個體本位(的);個體本位論
Xenophobia - 排外
Xenophobe - 排外者;排外(的)
Xenophobic - 排外(的)
Xenophilia - 親外
Xenophile - 親外者;親外(的)
Militarism - 軍國主義
Militarist - 軍國主義者;軍國主義(的)
Militaristic - 軍國主義(的)
Pacifism - 和平主義
Pacifist - 和平主義者;和平主義(的)
Pacifistic - 和平主義(的)
Spiritualism - 精神主義
Spiritualist - 精神主義者
Spiritualistic - 精神主義(的)
Materialism - 物質主義
Materialist - 物質主義者
Materialistic - 物質主義(的)
Neutral - 中立
Authoritarianism - 威權主義
Egalitarianism - 平等主義

# 事件名詞
Curators - 典藏研究員/典藏研究所
Riggan - 瑞玵
XuraCorp - 旭然集團
Muutagan - 穆塔鋼
Drake - 龍獸
Pantagruel - 龐大固埃
Gargantua - 高康大
Stellar Devourer - 噬星者

Tiyanki - 天凱
Cybrex - 賽博霸王
Void Cloud - 虛空之雲
Space Amoeba - 太空阿米巴

Javorian Pox - 楓痘   # 原來翻譯成 傑法利亞瘟疫 和 賈沃安瘟疫 不統一，所以乾脆瞎起了個易讀的名字。楓來自克羅地亞語中的 Javor 痘指 Pox 。

#行為
Survey - 勘察
Jump - 躍遷
Uplift - 開化
Purge - 肅清;大清洗
Purging - 肅清;肅清中;大清洗
Disassemble - ?
Displace - 驅離

Click - 點擊
Right Click - 右鍵點擊

# 科技/武器
Deflector - 偏向器
X-ray Laser - X射線雷射
Garrison - 駐軍
Drone - 無人機
Droid - 人型機器人
Projectile (weapon) - 投射武器
Warp - 曲速
HyperDrive - 超空間驅動
JumpDrive - 折躍引擎
Psionic - 靈能
FTL - 超光速引擎(FTL)
FTL travel - 超光速航行
Hyperlane - 超空間航道
Positronic - 正電子

#外交
League of Non-Aligned Powers - 不結盟力量聯合體
Tributary - 藩屬國
Vassal - 臣屬國
Thrall - 僕從國
Dominion - 自治領
Signatory - 協約國
Satellite - 衛星國
Lord - 宗主國
Subject - 附庸
Embassy - 大使館;外交使節

#名詞
modifier - 修正;調整因素
Government - 政體;政府
government form - 政體;政府形式
government type - 政體;政府形式
Edict - 法令
committee - 委員會
council - 議會
cost - 消耗
lesser lifeform - 低級生物
Authority - 權力制度
Civic - 公民性
Tradition - 傳統
Ascension Perk - 飛昇特典
(Orbital) Habitat - 太空移民站
Shroud - 天幕
synthetic - 合成人

Hotkey - 快捷鍵
Habitability - 宜居性
Subspace - 亞空間
Homeworld - 母星
Frontier - 邊境
Ship - 星艦
Species - 種族
Sector - 星域
Spaceport - 太空港
Station - 基地
Power - 能量
Energy (credits) - 能源(點數)
Unity - 凝聚力

Xeno - 異星;異族;異種;異形  #視語境
Dimension(al) - 次元;次元(作第n次元時用)
Extradimension(al) - 異次元

Fallen Empire - 墮落帝國

Molten World - 熔岩世界
Frozen World - 寒冰世界
Barren World - 荒蕪世界
Desert World - 沙漠世界
Arid World - 旱地世界
Tundra World - 凍原世界
Continental World - 大陸世界
Tropical World - 熱帶世界
Ocean World - 海洋世界
Arctic World - 極地世界
Alpine World - 高寒世界
Savannah World - 草原世界
Toxic World - 劇毒世界
Gaia World - 蓋亞世界

megastructure - 巨型結構
Yurantic Crystals - 羽然水晶

Whisperers in the Void - 虛咽靈尊
Composer of Strands - 譜命靈尊
Eater of Worlds - 吞世靈尊
Instrument of Desire - 極欲靈尊
End of the Cycle - 終寰靈尊

Gestalt Consciousness - 完形意識

organic creator - 有機創造者
organic - 有機體
Machine - 機械體
Machine Intelligence - 機械智慧體
Bio-Trophy  - 生化展品

cybernetics - 神經機械學
cybernetic implant - 機械內植體
implant - 內植物
cyborg - 半機械人
cybernetic unit - 半機械單元
cybernetic - 半機械化

Pre-Sapient - 亞智慧; 亞智慧物種
warform - 作戰體